@@@@@@@@@@@@@@@@@@@@@@@@
#              #    $  #
#              #       #
# $$           #     $ #
#              @@  @@@@#
#                      #
#                      #
#         &            #
#              E       #
#$$$                   #
#        $$$           #
#                      #
#                      #
@@@@@@@@@@@@@@@@@@@@@@@@
