@@@@@@@@@@@@@@@@@@@@@@@@
#              #       #
#              #    +  #
# $$           #       #
#              @@  @@@@#
#                      #
#             %        #
#         &            #
#                      #
#$$$                   #
#        $$$           #
#                      #
#                      #
@@@@@@@@@@@@@@@@@@@@@@@@
